Abaixo temos a descrição dos 38 campos que formam o conjunto de dados:
• numero_solicitacao: Número da solicitação;
• razaoSocial: Razão Social Anonimizada;
• nomeFantasia: Nome Fantasia Anonimizado;
• cnpjSemTraco: CNPJ Anonimizado;
• maiorAtraso: Maior atraso de pagamento em dias;
• margemBrutaAcumulada: Margem bruta acumulada;
• percentualProtestos: Percentual protestos;
• primeiraCompra: Data da primeira compra na empresa;
• prazoMedioRecebimentoVendas: prazo médio do recebimento de vendas do cliente;
• titulosEmAberto: valor total de títulos em aberto; 
• valorSolicitado: valor de crédito solicitado
• status: Status da solicitação: 
• AprovadoAnalista: aprovado por um analista
• AprovadoComite: aprovado por um comitê, normalmente para valores mais expressivos
• AguardandoAprovacao: aguardando aprovação
• DocumentacaoReprovada: documentação reprovada
• EmAnaliseDocumentacao: em Análise da documentação
• ReprovadoAnalista: reprovado por um analista
• ReprovadoComite: reprovado por um comitê
• definicaoRisco: categorização de risco;
• percentualRisco: onde 0 é baixo e 1 é alto;
• diferencaPercentualRisco: 1 - percentualRisco;
• dashboardCorrelacao: uma correlação interna de risco, mas que os analistas não conseguiram explicar nas reuniões realizadas;
• valorAprovado: Valor que foi aprovado pelos analistas;
• dataAprovadoEmNivelAnalista: data em que a solicitação de crédito foi aprovada por um analista de crédito;
• dataAprovadoEmComite: data em que a solicitação de crédito foi aprovada por um comitê;
• periodoBalanco: Período do balanço informado na documentação da empresa;
• ativoCirculante: Ativo circulante informado na documentação da empresa;
• passivoCirculante: Passivo circulante informado na documentação da empresa;
• totalAtivo: Ativo informado na documentação da empresa;
• totalPatrimonioLiquido: Patrimonio líquido informado na documentação da empresa;
• endividamento: Endividamento informado na documentação da empresa;
• duplicatasAReceber: Duplicatas a receber informado na documentação da empresa;
• estoque: estoque Informado na documentação da empresa;
• faturamentoBruto: Faturamento bruto informado na documentação da empresa;
• margemBruta: Margem bruta informado na documentação da empresa;
• periodoDemonstrativoEmMeses: Período do demonstrativo informado na documentação da empresa;
• custos : Custos informado na documentação da empresa;
• limiteEmpresaAnaliseCredito: limite de crédito fornecido por uma empresa externa de análise de crédito;
• anoFundacao: Ano de fundação da empresa;
• intervaloFundacao: Categoria do ano de fundação;
• capitalSocial: Capital social informado na documentação da empresa;
• restricoes: Flag informando se existem restrições relacionadas ao cliente;
• empresa_MeEppMei: Flag informando se o cliente é um pequeno negócio; 
• scorePontualidade: score de pontualidade entre 0 e 1, onde é significa que o cliente é pontual;